﻿##########~#########################################
#######-------#######--@--#################-@-######
#######-------#######-----#################---######
#######-------########---###################-#######
###########---########---###############-----#######
###########---#######------#############-###########
###########---#######--!---#############-###########
############-########------#############-###########
############*########--------------------###########
############-#########---#####-#########-###########
############-#########---#####-#########-###########
############-------------####---########-###########
######################---####-@-######-----#########
######################---#############-----#########
#############------------------------------#########
#############-----####---#############--?--#########
#############-----####---#############-----#########
#######-@-###--*--####---###########################
#######---#####-######---###########################
#######---#####-######---###########################
#######---------######---###########################
#######################=############################