﻿####################################################
#####-----##############-$-#########################
#####-----##############------------------##########
#####-@-------------####---##############*##########
#####-----#########-####***##############-##########
#####-----#########-###-----#############-##########
###################-##-------############-##########
###################------------#######-------#######
###################------?------######-------#######
###################-------------######-------#######
###################----------------------!---#######
#########-----------------------######-------#######
#########-#########-------------######-------#######
#########-#########-------------######-------#######
#########-#########-------------#########-##########
#########-#########-------------#########-##########
#########-###############-###############-##########
########---##############-###############-##########
########----------------------------------##########
########---##############-##########################
#########################-##########################
#########################=##########################