﻿######~#############################################
######-#############################################
######-##############---@---#############-@-########
######-#############---------############---########
######-#############---------############---########
######-------*---###---------#############-#########
##########-#####-###----!----#############-#########
#########---####-###---------#############-#########
#########-@-####-###---------#############-#########
################-###---------###########-----#######
##--------######-#######-###############--?--#######
##-@-----------------------------------------#######
##--------######-#######-###############-----#######
################-#######-###############-----#######
################-#######-################-##########
######-----#####-#######-################-##########
######-----#####-######---##############-------#####
######@----------------------------------------#####
######-----############---##############-------#####
######-----#############-###############-------#####
########################-###############-------#####
########################=###########################